9 480 10 13
7 6
10 8
8 10
N N N E N N N N N N E N N N E N N N N E N N N N N N N E
N N N N N N E N N N N N N N N N E E N E N N N N E B B B
N E E N N N N N E N E N N N N B B B N N B B N B B N N N
N N N N N N N N N N N N N N B N N E B B N N B E N N N N
N N N N N N E N N E N N N B N N N N N N N N N N E E N N
N E N N N E N E N N N B B E N N N E N N N N E N N N N N
E N N N N E E N N B B E N N N E N E N E N N N E N N E E
N B B N N N B N B N N N N N N N N N N N N N N N N N N N
B N E B N B N B E N N N E E E N E E N N E N N N N E N N
N N N E B N N N N N N N N N E E N N N N N E N N N N E N
N E E N N E N N N N E E N E E N N N E E N N N N N N N N
N N E N N N N N N N N N N N N E N N N N N E E N N N N N
E N N N N E N E N N N N E N N E N N N N N N N N E E N N
N N E N N N N N N N N E N N N E E N N N N N N N N N N E
N E N N N N N N N E N N N E E N N N E N N E N N N N N N
N N N N N N N N N N N N N N N N N E N N N N N N E N N N
N N N N E N E N N E E N E N E N N N N N N N N N N N N N
N N N E N N N N N N N N N N N E N N N N N N N N N N N N