30 250 15 5
20 1
15 3
13 6
12 8
12 10
10 12
9 15
3 0
N N N N N N N N N B B B N
N B N B N N N B B R R D B
B B B B B B B R R U B D B
R R R R D B B U B B B D B
B B B B D B B U B B B D B
N B N B R R R U B B B D B
N N N B B B B B B B B D B
N N N N N N N B N B B R R
N N N N N N N N N N B B B
