10 50 5 3
5 1
3 2
2 3
B B B B B N N N N N N N N
B B B B B N N N N N N N N
E E E E B B B B B B N N N
N N N E B B B N N B B N N
N N N E B N N N N B B B B
N N N E B B B B B B B B B
N N N E E E E B B B N N N
N N N N N N E B B B B B B
N N N N N N E E E E E E E
