10 150 20 5
5 1
3 3
2 5
3 0
B B B B B N N N N N N N N
B B B B B N N N N R R D N
B B B B B B B R R U N D N
R R R R D B B U N B B D N
B B B B D N N U N B B D B
B B B B R R R U B B B D B
N N N N N N N B B B N D N
N N N N N N N B B B B R R
N N N N N N N N N N N N N
