15 100 30 10
7 1
5 2
4 3
1 0
N B B N B B N B B N B B N
R R R R R R R R R R R R D
B B N B B N B B N B B N D
D L L L L L L L L L L L L
D N B B N B B N B B N B B
R R R R R R R R R R R R D
B B N B B N B B N B B N D
D L L L L L L L L L L L L
D N B B N B B N B B N B B
