40 200 100 3
5 1
3 2
2 3
3 0
B B B B B N N N N N N N N
B B B B B N N N N R R D N
N N N N B B B R R U N D N
R R R R D B B U N B B D N
N N N N D N N U N B B D B
N N N N R R R U B B B D B
N N N N N N N B B B N D N
N N N N N N N B B B B L L
N N N N N N N N N N N N N
