30 300 50 40
40 1
25 1
25 2
20 4
20 6
18 8
15 9
0 0
R D N N N N N N N N B N B
B R D B N N N N N B R R R
B B R D B N N N N N U B N
N N B R D B N N N B U N B
B N B B R D B N B N U B N
B N N B N R D B N B U N B
N B B B B B R D N N U B N
N N B N N B B R D B U N B
N N N B B N B B R R U B N