10 50 30 5
5 1
3 3
2 5
8 7
12 9
10 11
9 13
1 0
N N N N N N N N N N N N N
R R R R R R R R R R D B N
B B B B B B B B B B D B N
N N N N N N N N N B D B N
N N N N N N N N N B D B N
N N N N N N N N N B D B N
B B B B B B B B B B D B N
L L L L L L L L L L L B N
N N N N N N N N N N N N N
