40 200 50 20
15 1
10 3
8 4
0 1
N D N B N N N N N B U N N
B D B N B N B N N N U B N
N D N B N B N B N B U N N
B R R R R R D B N N U B N
N N B N B N D B N B U N N
B B N B N B D B N N U B N
N D L L L L L B N B U N N
B D N B B N B N B N U B N
N R R R R R R R R R U B N
