120 600 5 3
5 1
3 2
2 3
0 2
B B D B B N N N N N U N N
B B D B B N N N N N U N N
N N D N B B B N N N U N N
N N D N N B B N N B U N N
N N D N N N N N N B U N B
N N D N N N N N B B U N B
N N D N N N N B B B U N N
N N D N N N N B B B U N N
N N R R R R R R R R U N N
