80 500 50 80
40 1
35 2
25 3
8 10
N N N N N N N N N N N N N
D L L L L L L L L L L L L
D N N N N N N N N N N N U
R R D N N N N N N N R R U
N N D N N N N N N N U N N
D L L N N N N N N N U L L
D N N N N N N N N N N N U
R R D N N N N N N N R R U
N N D N N N N N N N U N N
